(
    name: "Level Uno",
    spawn_stage_id: 0,
    gateway_pairs: PairMap(
        map: {
            (0, 1): (7, 1),
            (7, 2): (4, 1),
            (4, 2): (8, 1),
            (7, 1): (0, 1),
            (4, 1): (7, 2),
            (8, 1): (4, 2),
            (4, 3): (1, 1),
            (1, 1): (4, 3),
        }
    )
)
